90 50
..........................................................................................
..........................................................................................
..........................................................................................
..........................................................................................
..........................................................................................
.......................................................XXXXXXX............................
.......................................................XXXXXXX............................
.......................................................XXXXXXX............................
.......................................................XXXXXXX............................
..........XXXXXXX.....................................................S...................
..........XXXXXXX.........................................................................
..........XXXXXXX........XXXXXXX..........................................................
..........XXXXXXX........XXXXXXX..........................................................
.........................XXXXXXX..........................................................
.........................XXXXXXX...............................XXXXXXX....................
...............................................................XXXXXXX....................
...............................................................XXXXXXX....................
...............................................................XXXXXXX....................
..........................................................................................
................................DDDDDDD...................................................
................................DDDDDDD...................................................
................................DDDDDDD...................................................
................................DDDDDDD...................................................
.......................................................................DDDDDDD............
.......................................................................DDDDDDD............
................XXXXXXX................................................DDDDDDD............
................XXXXXXX.........................DDDDDDD................DDDDDDD............
................XXXXXXX.........................DDDDDDD...................................
................XXXXXXX.........................DDDDDDD...................................
................................................DDDDDDD...................................
..........................................................................................
........................XXXXXXX............................................XXXXXXX........
........................XXXXXXX............................................XXXXXXX........
........................XXXXXXX............................................XXXXXXX........
........................XXXXXXX.......DDDDDDD..............................XXXXXXX........
.......DDDDDDD........................DDDDDDD.............................................
.......DDDDDDD........................DDDDDDD.............................................
.......DDDDDDD........................DDDDDDD.......................XXXXXXX...............
.......DDDDDDD......................................................XXXXXXX...............
....................................................................XXXXXXX...............
..................S.................................................XXXXXXX...............
.............................................XXXXXXX......................................
.............................................XXXXXXX......................................
.............................................XXXXXXX......................................
.............................................XXXXXXX......................................
..........................................................................................
..........................................................................................
..........................................................................................
..........................................................................................
..........................................................................................
