90 50
..........................................XXXXX...........................................
..........................................XXXXX...........................................
..........................................XXXXX...........................................
..........................................XXXXX...........................................
..........................................XXXXX...........................................
..........................................DDDDD...........................................
..........................................DDDDD...........................................
..........................................DDDDD...........................................
..........................................DDDDD...........................................
..........................................................................................
......................XXXXX....................................XXXXX......................
......................XXXXX....................................XXXXX......................
......................XXXXX....................................XXXXX......................
......................DDDDD....................................DDDDD......................
......................DDDDD....................................DDDDD......................
......................DDDDD....................................DDDDD......................
......................DDDDD....................................DDDDD......................
......................XXXXX....................................XXXXX......................
......................XXXXX....................................XXXXX......................
......................XXXXX....................................XXXXX......................
.............XXXXX.....................X.........X......................XXXXX.............
.............XXXXX....................X...........X.....................XXXXX.............
.............XXXXX...................D.............D....................XXXXX.............
.............XXXXX..................D...............D...................XXXXX.............
.............XXXXX..................D...............D...................XXXXX.............
........S....XXXXX...................D.............D....................XXXXX....S........
.............XXXXX....................X...........X.....................XXXXX.............
.............XXXXX.....................X.........X......................XXXXX.............
.............XXXXX......................................................XXXXX.............
.............XXXXX......................................................XXXXX.............
......................XXXXX....................................XXXXX......................
......................XXXXX....................................XXXXX......................
......................XXXXX....................................XXXXX......................
......................DDDDD....................................DDDDD......................
......................DDDDD....................................DDDDD......................
......................DDDDD....................................DDDDD......................
......................DDDDD....................................DDDDD......................
......................XXXXX....................................XXXXX......................
......................XXXXX....................................XXXXX......................
......................XXXXX....................................XXXXX......................
..........................................................................................
..........................................DDDDD...........................................
..........................................DDDDD...........................................
..........................................DDDDD...........................................
..........................................DDDDD...........................................
..........................................XXXXX...........................................
..........................................XXXXX...........................................
..........................................XXXXX...........................................
..........................................XXXXX...........................................
..........................................XXXXX...........................................
