90 50
..........................................................................................
..........................................................................................
..........................................................................................
..........................................................................................
..........................................................................................
....................................S.....................................................
..........................................................................................
..........................................................................................
..........................................................................................
..........................................................................................
.......................XXXXXXXDDDXXXXXXXXXXXXX............................................
.......................XXXXXXXDDDXXXXXXXXXXXXXX...........................................
.......................XXXXXXXDDDXXXXXXXXX................................................
.......................XXXXXXXDDDXXX......................................................
.......................XXXXXXDD...........................................................
..........................................................................................
..........................................................................................
..........................................................................................
..........................................................................................
..........................................................................................
..........................................................................................
...................................XXXXXXXXXXXXXXX........................................
...................................XXXXXXXXXXXXXXX........................................
.............XXXXXX................XXXXXXXXXXXXXXX.........................XXXX...........
.............XXXXXX........................................................XXXX...........
...........................................................................XXXX...........
...........................................................................XXXX...........
..................................................XXXXXXXXXXXX............................
.....................X............................XXXXXXXXXXXX............................
......................X...........................XXXXXXXXXXXX............................
.......................X..................................................................
..........................................................................................
..........................................................................................
..........................................................................................
..........................................................................................
..........................................................................................
....XXXX.......................XXXDDDXXXXXX...............................................
...X.......................XXXXXXXDDDXXXXXXX..............................................
..X....................XXXXXXXXXXXDDDXXXXXXXX.............................................
.X.....................XXXXXXXXXXXDDDXXXXXXXXX............................................
X.........................................................................................
..........................................................................................
..........................................................................................
..........................................................................................
..........................................................................................
.................................S........................................................
..........................................................................................
..........................................................................................
..........................................................................................
..........................................................................................
