90 50
..........................................................................................
..........................................................................................
..........................................................................................
..........................................................................................
..........................................................................................
....................................S.....................................................
..........................................................................................
..........................................................................................
..........................................................................................
..........................................................................................
.......................XXXXXXXXXXXXXXXXXXXXXXX............................................
.......................XXXXXXXXXXXXXXXXXXXXXXXX...........................................
.......................XXXXXXXXXXXXXXXXXXX................................................
.......................XXXXXXXXXXXXX......................................................
.......................XXXXXXXX...........................................................
..........................................................................................
..........................................................................................
..........................................................................................
..........................................................................................
..........................................................................................
..........................................................................................
...................................XXXXXXXXXXXXXXX........................................
...................................XXXXXXXXXXXXXXX........................................
.............XXXXXX................XXXXXXXXXXXXXXX.........................XXXX...........
.............XXXXXX........................................................XXXX...........
...........................................................................XXXX...........
...........................................................................XXXX...........
..................................................XXXXXXXXXXXX............................
.....................X............................XXXXXXXXXXXX............................
......................X...........................XXXXXXXXXXXX............................
.......................X..................................................................
..........................................................................................
..........................................................................................
..........................................................................................
..........................................................................................
..........................................................................................
....XXXX.......................XXXXXXXXXXXX...............................................
...X.......................XXXXXXXXXXXXXXXXX..............................................
..X....................XXXXXXXXXXXXXXXXXXXXXX.............................................
.X.....................XXXXXXXXXXXXXXXXXXXXXXX............................................
X.........................................................................................
..........................................................................................
..........................................................................................
..........................................................................................
..........................................................................................
.................................S........................................................
..........................................................................................
..........................................................................................
..........................................................................................
..........................................................................................
