20 15
X...................
....................
................S...
....................
....................
........DDD.........
........DDD.........
........DDD.........
....................
....................
.X..................
...X................
................X...
..S................X
..................XX
