20 15
X...................
....................
................S...
....................
...P................
........DDD.........
........DDD.........
..B.....DDD.........
..B.................
....................
.X..............P...
...X................
................X...
..S................X
..................XX
POWERUPS:
  SPAWNS: FAST
TIMER: 2000
